。	｡	名詞
「	｢	名詞
」	｣	名詞
あっせつ	圧接	さ変名詞
あつこう	厚鋼	名詞
あつそう	圧送	さ変名詞
あつちょう	圧調	さ変名詞
あつふう	圧封	さ変名詞
あつゆ	圧油	さ変名詞
あんかん	安環	名詞
あんすい	安水	名詞
あんたい	安対	名詞
いえき	移液	さ変名詞
いり	入	名詞
うすかた	薄形	名詞
うすがた	薄形	名詞
うすこう	薄鋼	名詞
うずど	渦度	名詞
えきあん	液安	名詞
えきい	液位	名詞
えきえん	液塩	名詞
えきそう	液層	名詞
えきそう	液相	名詞
えきちゅう	液柱	名詞
えきちょう	液調	さ変名詞
えきふう	液封	さ変名詞
えきらく	液絡	さ変名詞
えんせき	塩析	さ変名詞
えんてん	延展	さ変名詞
おしこみ	押込	名詞
おんあつ	温圧	名詞
おんしん	温浸	さ変名詞
おんちょう	温調	さ変名詞
かあつ	過圧	さ変名詞
かいあつ	解圧	さ変名詞
かいかん	解管	さ変名詞
かいかん	開環	さ変名詞
かいかん	開管	さ変名詞
かいけっかん	解結管	さ変名詞
かいけっせん	解結線	さ変名詞
かいこう	階高	名詞
かいさい	解砕	さ変名詞
かいさき	開先	名詞
かいしょく	壊食	さ変名詞
かいせん	解線	さ変名詞
かおん	過温	さ変名詞
かくそく	隔測	さ変名詞
かけ	×	名詞
かこう	架構	名詞
かたこう	形鋼	名詞
かたしき	形式	名詞
かたもち	片持	さ変名詞
かっせん	活線	名詞
かれい	過冷	さ変名詞
かんこ	乾固	さ変名詞
かんしゅつ	缶出	さ変名詞
かんしょく	乾食	さ変名詞
きさ	器差	名詞
きせん	輝線	名詞
きそう	気層	名詞
きそう	気相	名詞
きゅうえき	給液	さ変名詞
きゅうこう	吸光	さ変名詞
きょうちん	共沈	さ変名詞
きょうふつ	共沸	さ変名詞
きんあつ	均圧	さ変名詞
きんすい	禁水	さ変名詞
きんゆ	禁油	さ変名詞
ぎゃくし	逆止	さ変名詞
ぎゃくせん	逆洗	さ変名詞
ぎゃくせん	逆栓	名詞
けいそう	計装	さ変名詞
けっかん	結管	さ変名詞
けっそく	欠測	さ変名詞
けんだく	懸濁	さ変名詞
けんでん	検電	さ変名詞
げんおん	減温	さ変名詞
げんせつ	現説	さ変名詞
げんたい	原体	名詞
こうすい	工水	名詞
こうそく	交束	さ変名詞
こうばん	工番	名詞
こうふつ	高沸	さ変名詞
こうりゅう	向流	さ変名詞
こうりゅう	後溜	さ変名詞
こうりゅう	後留	さ変名詞
こけつ	固結	さ変名詞
こそう	固相	名詞
こんしょう	混床	名詞
ごそうさ	誤操作	さ変名詞
さいぼうきょう	災防協	名詞
さんせん	酸洗	さ変名詞
ざあつ	座圧	名詞
ざめん	座面	名詞
ざんあつ	残圧	さ変名詞
ざんえき	残液	さ変名詞
ざんこう	漸降	さ変名詞
しきど	色度	名詞
しせい	試製	さ変名詞
しゅうき	集気	さ変名詞
しゅうりゅう	終溜	さ変名詞
しゅうりゅう	終留	さ変名詞
しゅくりゅう	縮流	さ変名詞
しゅりゅう	主留	さ変名詞
しゅりゅう	主溜	さ変名詞
しょうおん	昇温	さ変名詞
しょうこう	照光	さ変名詞
しょうしゅつ	晶出	さ変名詞
しょうせき	晶析	さ変名詞
しょうほう	消泡	さ変名詞
しょりゅう	初留	さ変名詞
しょりゅう	初溜	さ変名詞
しんすう	心数	名詞
しんすう	芯数	名詞
じぎり	地切り	さ変名詞
じくりゅう	軸流	名詞
じねん	自燃	さ変名詞
じゅあつ	受圧	さ変名詞
じゅうえき	充液	さ変名詞
じゅうどう	従動	さ変名詞
じゅき	受器	名詞
じょうちゅう	常昼	さ変名詞
じょがい	除害	さ変名詞
じょじん	除塵	さ変名詞
じょだく	除濁	さ変名詞
じょてつ	除鉄	さ変名詞
じょでん	除電	さ変名詞
すいせん	水栓	名詞
すいてん	水添	さ変名詞
すいふう	水封	さ変名詞
せいせん	正栓	名詞
せいたん	成端	さ変名詞
せいち	静置	さ変名詞
せいち	正値	名詞
せいてい	整定	さ変名詞
せつえき	接液	さ変名詞
せつげん	節弦	名詞
せんえき	洗液	名詞
そうえき	送液	さ変名詞
そうがい	槽外	名詞
そうき	送気	さ変名詞
そうとう	双投	名詞
そうない	槽内	名詞
そくおん	測温	名詞
そりゅう	粗留	さ変名詞
ぞうえん	造塩	さ変名詞
ぞうしつ	像質	名詞
たいしん	耐振	名詞
たしん	多心	名詞
たしん	多芯	名詞
たまかけ	玉掛	さ変名詞
たまかけ	玉掛け	さ変名詞
たよく	多翼	名詞
たんせつ	鍛接	さ変名詞
たんり	単離	さ変名詞
だくど	濁度	名詞
だっき	脱気	さ変名詞
だっき	脱揮	さ変名詞
だっちゃく	脱着	さ変名詞
だつあつ	脱圧	さ変名詞
ちくあつ	蓄圧	さ変名詞
ちっか	窒化	さ変名詞
ちゅうそう	中操	名詞
ちゅうふつ	中沸	さ変名詞
ちゅうりゅう	中留	さ変名詞
ちゅうりゅう	中溜	さ変名詞
ちょっかん	直管	名詞
つうえき	通液	さ変名詞
つぎて	継手	名詞
つりに	吊荷	名詞
つりに	吊り荷	名詞
ていしゅう	定修	さ変名詞
ていふつ	低沸	さ変名詞
てきか	滴加	さ変名詞
てきてい	滴定	さ変名詞
とうがい	塔外	名詞
とうそう	塔槽	名詞
とうちょう	塔頂	名詞
とうない	塔内	名詞
としゅつ	吐出	さ変名詞
とっぷつ	突沸	さ変名詞
とりせつ	取説	名詞
どうあつ	導圧	さ変名詞
どうあつ	同圧	形動名詞
どうおん	同温	形動名詞
どうろ	導路	名詞
ないおん	内温	名詞
ないたい	内袋	名詞
ないはい	内配	さ変名詞
にくそく	肉測	さ変名詞
にくもり	肉盛	さ変名詞
ねつでん	熱電	名詞
のべゆか	延床	名詞
はざい	端材	名詞
はってい	発停	さ変名詞
はっぽう	発報	さ変名詞
ばくちゃく	爆着	さ変名詞
ばくひ	爆飛	さ変名詞
ばっき	抜気	さ変名詞
ばつえき	抜液	さ変名詞
ひえき	被液	さ変名詞
ひかん	樋管	名詞
ひしょく	比色	さ変名詞
ひらい	避雷	さ変名詞
ひんかん	品管	さ変名詞
ひんしょう	品証	さ変名詞
ふうあつ	封圧	さ変名詞
ふうえき	封液	さ変名詞
ふくざ	複座	名詞
ふち	負値	名詞
ぶんえき	分液	さ変名詞
ぶんでん	分電	さ変名詞
ぷらまい	±	名詞
へいかん	閉環	さ変名詞
へいかん	閉管	さ変名詞
へいさん	並産	さ変名詞
へいりゅう	並流	さ変名詞
へんしん	偏心	さ変名詞
べんざ	弁座	名詞
べんたい	弁体	名詞
べんばこ	弁箱	名詞
べんぼう	弁棒	名詞
ほあつ	保圧	さ変名詞
ほうあつ	放圧	さ変名詞
ほうばく	放爆	さ変名詞
ほしん	歩進	さ変名詞
ほんあん	本安	名詞
ぼうえき	防液	さ変名詞
ぼうてき	防滴	さ変名詞
ぼうゆ	防油	さ変名詞
ぼっすい	没水	さ変名詞
めんあつ	面圧	名詞
もとあつ	元圧	名詞
や	→	名詞
や	←	名詞
や	↑	名詞
や	↓	名詞
や	⇒	名詞
や	⇔	名詞
やくちゅう	薬注	さ変名詞
ゆうごう	遊合	さ変名詞
ゆせん	湯洗	さ変名詞
ゆそう	油相	名詞
ゆふう	油封	さ変名詞
ゆやけ	油焼け	さ変名詞
ゆよく	油浴	さ変名詞
ようえき	用役	名詞
ようか	溶加	さ変名詞
ようてい	揚程	名詞
ようぶ	要部	名詞
ようり	溶離	さ変名詞
ようりょう	容量	名詞
よくげん	翼弦	名詞
よくれつ	翼列	名詞
よこもち	横持	さ変名詞
よこもち	横持ち	さ変名詞
よもり	余盛	さ変名詞
りきりつ	力率	名詞
りゅうかい	粒界	名詞
りゅうしゅつ	留出	さ変名詞
りゅうしゅつ	溜出	さ変名詞
りゅうせん	流線	名詞
りゅうぶん	留分	名詞
りゅうぶん	溜分	名詞
りょうもち	両持	さ変名詞
りょうもち	両持ち	さ変名詞
れいしん	冷浸	さ変名詞
れんせい	連成	名詞
・	･	名詞
